11111111111111
100000000000C1
10000000000001
10000000010001
100C0000000001
10000000000001
10001111000001
10000000000001
10000000000001
10001111100001
10000000000001
100000001C0001
10000000100001
10111000100001
1P0000001000E1
11111111111111
