1111111111
1C00100001
10001C0001
1000000001
1011110001
1000000C01
100C001001
1110011001
10P00E1001
1111111111
