R 1024 1024 
NXT ./rudy.cub

NO ./tex/elinia1.xpm
SO ./tex/elinia.xpm
WE ./tex/elinia2.xpm
EA ./tex/elinia3.xpm

S ./tex/slime.xpm ./tex/tree_st.xpm ./tex/orange_potion.xpm ./tex/power1.xpm ./tex/potal_elinia.xpm ./tex/tree_weapon.xpm ./tex/magic_1.xpm ./tex/magic_2.xpm ./tex/magic_3.xpm ./tex/magic_4.xpm ./tex/magic_5.xpm ./tex/magic_6.xpm
F ./tex/elinia_floor.xpm
C ./tex/elinia_sky1.xpm

       11111111111111111111111111
       11111111111111111111111111
       11000000000110000000000001
       11011000011110200000000001
111111111001000000000000000010201
111111111011020001110020000015041             
1100000000011400001110011110011111111111111111111111111111111111
1101101111011110111000000010000000001000001000040000000010000001
1161101111001410111010100100002002001000000200200000002010420001
1115020001101010111000000400000000001000000000000000010000000001
1100000200000000000000000000300000000020000000002000010000103501
110200000000040001101010000000000100040000005001000001000010N001
1110020011101010111110110222011111111111111111111111111111111111
111150011 1140001 150010400001
111111111 1111111 111111111111


