R 1024 768
NO ./tex/eagle.xpm
SO ./tex/greystone.xpm
WE ./tex/redbrick.xpm
EA ./tex/purplestone.xpm

S ./tex/slime.xpm
F ./tex/colorstone.xpm
C ./tex/wood.xpm

        1111111111111111111111111
        1000000000110000000000001
        1011000001110002002N02001
        1001010000000000000020001
111111111011001001110000000000001
100000000011000001110111111011111
10010110011111011100000010001
11110111001111011101010010001
11000000100101000000000000001
10002000000000001100000000201
10000000000000000001010010001
1100000111010101111101111000111
11110111 1110101 101111010001
11111111 1111111 111111111111
