R 1024 1024 
NXT ./jakum.cub

NO ./tex/rudy1.xpm
SO ./tex/rudy2.xpm
WE ./tex/rudy3.xpm
EA ./tex/rudy4.xpm

S ./tex/toy_horse_128.xpm ./tex/sonz.xpm ./tex/icecream.xpm ./tex/power1.xpm ./tex/rudy_potal.xpm ./tex/sonz_weapon.xpm ./tex/cold1.xpm ./tex/cold2.xpm ./tex/cold3.xpm ./tex/cold4.xpm ./tex/cold5.xpm ./tex/cold6.xpm ./tex/cold7.xpm ./tex/cold8.xpm ./tex/cold9.xpm ./tex/cold10.xpm ./tex/cold11.xpm ./tex/cold12.xpm
F ./tex/rudy_bottom.xpm
C ./tex/rudy_sky.xpm

        1111111111111111111111111        111111111111111111111111
        1111111111111111111111111        111111111111111111111111
        1000000002112001400000001        100000000210020000000011
        1211000011110001000000001        101020100010000001000011
111111111004000000000001000010001        100111000000024501230011111
1111111111200000001110002000010201        13002000111111111111111111
11000000000002000011100000000111111111111111110000000020000000000011
11012102001115011100000001500000001200000310000000000000100000411011
116100111152000010000000021000000000100000002000000E0000000200013011
11100020011010101110000000100000000010000110000000000101111111010011
11000000000000000000000000000000010002000110000020000101     1012011
11002040000000000110111111001000010000000000000100003101     1000011
11100000111010101110000000001111111111111111111111111101     1011111
111150001 1120321 100010200001                       101  111101111
11111100111111111 111111110001            11111111111101  1400011
     1021               10001     11111  13002000000001  10200111
     1001               10001     100011110000401111111  1000511
     1001           111110001111111000000000111011       1011111
     10011111111111110200000004002000000000000001        101111
     12000000000000000000000000000000000200020001        1011
     11111111100111111101110111111111111100000001        1011
             10011    1011101           102000201111111111011
             14531    1402051           100040000000000000011
             11111    1111111           111111111111111111111
             11111    1111111           111111111111111111111
